issue,prize,hundred,ten,unit,sum,tail,gap
2022001,378,3,7,8,18,8,5
2022002,287,2,8,7,17,7,6
2022003,558,5,5,8,18,8,3
2022004,099,0,9,9,18,8,9
2022005,871,8,7,1,16,6,7
2022006,438,4,3,8,15,5,5
2022007,523,5,2,3,10,0,3
2022008,842,8,4,2,14,4,6
2022009,856,8,5,6,19,9,3
2022010,648,6,4,8,18,8,4
2022011,073,0,7,3,10,0,7
2022012,505,5,0,5,10,0,5
2022013,086,0,8,6,14,4,8
2022014,788,7,8,8,23,3,1
2022015,993,9,9,3,21,1,6
2022016,947,9,4,7,20,0,5
2022017,515,5,1,5,11,1,4
2022018,729,7,2,9,18,8,7
2022019,855,8,5,5,18,8,3
2022020,515,5,1,5,11,1,4
2022021,492,4,9,2,15,5,7
2022022,974,9,7,4,20,0,5
2022023,489,4,8,9,21,1,5
2022024,503,5,0,3,8,8,5
2022025,974,9,7,4,20,0,5
2022026,618,6,1,8,15,5,7
2022027,924,9,2,4,15,5,7
2022028,961,9,6,1,16,6,8
2022029,134,1,3,4,8,8,3
2022030,460,4,6,0,10,0,6
2022031,605,6,0,5,11,1,6
2022032,703,7,0,3,10,0,7
2022033,358,3,5,8,16,6,5
2022034,922,9,2,2,13,3,7
2022035,402,4,0,2,6,6,4
2022036,087,0,8,7,15,5,8
2022037,341,3,4,1,8,8,3
2022038,393,3,9,3,15,5,6
2022039,475,4,7,5,16,6,3
2022040,591,5,9,1,15,5,8
2022041,533,5,3,3,11,1,2
2022042,500,5,0,0,5,5,5
2022043,096,0,9,6,15,5,9
2022044,538,5,3,8,16,6,5
2022045,429,4,2,9,15,5,7
2022046,387,3,8,7,18,8,5
2022047,815,8,1,5,14,4,7
2022048,712,7,1,2,10,0,6
2022049,487,4,8,7,19,9,4
2022050,070,0,7,0,7,7,7
2022051,846,8,4,6,18,8,4
2022052,466,4,6,6,16,6,2
2022053,566,5,6,6,17,7,1
2022054,269,2,6,9,17,7,7
2022055,277,2,7,7,16,6,5
2022056,099,0,9,9,18,8,9
2022057,147,1,4,7,12,2,6
2022058,047,0,4,7,11,1,7
2022059,592,5,9,2,16,6,7
2022060,210,2,1,0,3,3,2
2022061,353,3,5,3,11,1,2
2022062,892,8,9,2,19,9,7
2022063,773,7,7,3,17,7,4
2022064,615,6,1,5,12,2,5
2022065,994,9,9,4,22,2,5
2022066,408,4,0,8,12,2,8
2022067,013,0,1,3,4,4,3
2022068,717,7,1,7,15,5,6
2022069,586,5,8,6,19,9,3
2022070,702,7,0,2,9,9,7
2022071,371,3,7,1,11,1,6
2022072,683,6,8,3,17,7,5
2022073,200,2,0,0,2,2,2
2022074,089,0,8,9,17,7,9
2022075,761,7,6,1,14,4,6
2022076,171,1,7,1,9,9,6
2022077,918,9,1,8,18,8,8
2022078,352,3,5,2,10,0,3
2022079,854,8,5,4,17,7,4
2022080,450,4,5,0,9,9,5
2022081,168,1,6,8,15,5,7
2022082,678,6,7,8,21,1,2
2022083,328,3,2,8,13,3,6
2022084,946,9,4,6,19,9,5
2022085,279,2,7,9,18,8,7
2022086,935,9,3,5,17,7,6
2022087,133,1,3,3,7,7,2
2022088,907,9,0,7,16,6,9
2022089,844,8,4,4,16,6,4
2022090,579,5,7,9,21,1,4
2022091,809,8,0,9,17,7,9
2022092,818,8,1,8,17,7,7
2022093,958,9,5,8,22,2,4
2022094,488,4,8,8,20,0,4
2022095,140,1,4,0,5,5,4
2022096,824,8,2,4,14,4,6
2022097,096,0,9,6,15,5,9
2022098,915,9,1,5,15,5,8
2022099,464,4,6,4,14,4,2
2022100,444,4,4,4,12,2,0
2022101,124,1,2,4,7,7,3
2022102,345,3,4,5,12,2,2
2022103,046,0,4,6,10,0,6
2022104,083,0,8,3,11,1,8
2022105,642,6,4,2,12,2,4
2022106,625,6,2,5,13,3,4
2022107,064,0,6,4,10,0,6
2022108,415,4,1,5,10,0,4
2022109,092,0,9,2,11,1,9
2022110,893,8,9,3,20,0,6
2022111,956,9,5,6,20,0,4
2022112,762,7,6,2,15,5,5
2022113,653,6,5,3,14,4,3
2022114,997,9,9,7,25,5,2
2022115,836,8,3,6,17,7,5
2022116,707,7,0,7,14,4,7
2022117,457,4,5,7,16,6,3
2022118,470,4,7,0,11,1,7
2022119,046,0,4,6,10,0,6
2022120,939,9,3,9,21,1,6
2022121,621,6,2,1,9,9,5
2022122,357,3,5,7,15,5,4
2022123,154,1,5,4,10,0,4
2022124,224,2,2,4,8,8,2
2022125,264,2,6,4,12,2,4
2022126,259,2,5,9,16,6,7
2022127,117,1,1,7,9,9,6
2022128,843,8,4,3,15,5,5
2022129,005,0,0,5,5,5,5
2022130,395,3,9,5,17,7,6
2022131,266,2,6,6,14,4,4
2022132,782,7,8,2,17,7,6
2022133,654,6,5,4,15,5,2
2022134,229,2,2,9,13,3,7
2022135,048,0,4,8,12,2,8
2022136,656,6,5,6,17,7,1
2022137,244,2,4,4,10,0,2
2022138,426,4,2,6,12,2,4
2022139,136,1,3,6,10,0,5
2022140,277,2,7,7,16,6,5
2022141,755,7,5,5,17,7,2
2022142,563,5,6,3,14,4,3
2022143,158,1,5,8,14,4,7
2022144,016,0,1,6,7,7,6
2022145,728,7,2,8,17,7,6
2022146,194,1,9,4,14,4,8
2022147,196,1,9,6,16,6,8
2022148,408,4,0,8,12,2,8
2022149,464,4,6,4,14,4,2
2022150,887,8,8,7,23,3,1
2022151,113,1,1,3,5,5,2
2022152,044,0,4,4,8,8,4
2022153,155,1,5,5,11,1,4
2022154,406,4,0,6,10,0,6
2022155,057,0,5,7,12,2,7
2022156,789,7,8,9,24,4,2
2022157,417,4,1,7,12,2,6
2022158,891,8,9,1,18,8,8
2022159,240,2,4,0,6,6,4
2022160,044,0,4,4,8,8,4
2022161,507,5,0,7,12,2,7
2022162,707,7,0,7,14,4,7
2022163,771,7,7,1,15,5,6
2022164,189,1,8,9,18,8,8
2022165,457,4,5,7,16,6,3
2022166,451,4,5,1,10,0,4
2022167,299,2,9,9,20,0,7
2022168,553,5,5,3,13,3,2
2022169,469,4,6,9,19,9,5
2022170,789,7,8,9,24,4,2
2022171,924,9,2,4,15,5,7
2022172,342,3,4,2,9,9,2
2022173,546,5,4,6,15,5,2
2022174,284,2,8,4,14,4,6
2022175,151,1,5,1,7,7,4
2022176,416,4,1,6,11,1,5
2022177,242,2,4,2,8,8,2
2022178,921,9,2,1,12,2,8
2022179,946,9,4,6,19,9,5
2022180,312,3,1,2,6,6,2
2022181,071,0,7,1,8,8,7
2022182,406,4,0,6,10,0,6
2022183,188,1,8,8,17,7,7
2022184,966,9,6,6,21,1,3
2022185,545,5,4,5,14,4,1
2022186,153,1,5,3,9,9,4
2022187,718,7,1,8,16,6,7
2022188,481,4,8,1,13,3,7
2022189,235,2,3,5,10,0,3
2022190,748,7,4,8,19,9,4
2022191,210,2,1,0,3,3,2
2022192,681,6,8,1,15,5,7
2022193,162,1,6,2,9,9,5
2022194,780,7,8,0,15,5,8
2022195,122,1,2,2,5,5,1
2022196,123,1,2,3,6,6,2
2022197,930,9,3,0,12,2,9
2022198,037,0,3,7,10,0,7
2022199,332,3,3,2,8,8,1
2022200,303,3,0,3,6,6,3
2022201,213,2,1,3,6,6,2
2022202,902,9,0,2,11,1,9
2022203,629,6,2,9,17,7,7
2022204,666,6,6,6,18,8,0
2022205,468,4,6,8,18,8,4
2022206,222,2,2,2,6,6,0
2022207,465,4,6,5,15,5,2
2022208,632,6,3,2,11,1,4
2022209,356,3,5,6,14,4,3
2022210,630,6,3,0,9,9,6
2022211,321,3,2,1,6,6,2
2022212,644,6,4,4,14,4,2
2022213,829,8,2,9,19,9,7
2022214,822,8,2,2,12,2,6
2022215,062,0,6,2,8,8,6
2022216,762,7,6,2,15,5,5
2022217,514,5,1,4,10,0,4
2022218,745,7,4,5,16,6,3
2022219,292,2,9,2,13,3,7
2022220,380,3,8,0,11,1,8
2022221,246,2,4,6,12,2,4
2022222,291,2,9,1,12,2,8
2022223,058,0,5,8,13,3,8
2022224,897,8,9,7,24,4,2
2022225,431,4,3,1,8,8,3
2022226,989,9,8,9,26,6,1
2022227,613,6,1,3,10,0,5
2022228,544,5,4,4,13,3,1
2022229,766,7,6,6,19,9,1
2022230,901,9,0,1,10,0,9
2022231,466,4,6,6,16,6,2
2022232,642,6,4,2,12,2,4
2022233,867,8,6,7,21,1,2
2022234,887,8,8,7,23,3,1
2022235,824,8,2,4,14,4,6
2022236,885,8,8,5,21,1,3
2022237,699,6,9,9,24,4,3
2022238,622,6,2,2,10,0,4
2022239,289,2,8,9,19,9,7
2022240,195,1,9,5,15,5,8
2022241,073,0,7,3,10,0,7
2022242,089,0,8,9,17,7,9
2022243,474,4,7,4,15,5,3
2022244,124,1,2,4,7,7,3
2022245,846,8,4,6,18,8,4
2022246,832,8,3,2,13,3,6
2022247,446,4,4,6,14,4,2
2022248,049,0,4,9,13,3,9
2022249,006,0,0,6,6,6,6
2022250,015,0,1,5,6,6,5
2022251,124,1,2,4,7,7,3
2022252,167,1,6,7,14,4,6
2022253,916,9,1,6,16,6,8
2022254,735,7,3,5,15,5,4
2022255,339,3,3,9,15,5,6
2022256,405,4,0,5,9,9,5
2022257,792,7,9,2,18,8,7
2022258,196,1,9,6,16,6,8
2022259,448,4,4,8,16,6,4
2022260,469,4,6,9,19,9,5
2022261,026,0,2,6,8,8,6
2022262,329,3,2,9,14,4,7
2022263,335,3,3,5,11,1,2
2022264,786,7,8,6,21,1,2
2022265,464,4,6,4,14,4,2
2022266,210,2,1,0,3,3,2
2022267,534,5,3,4,12,2,2
2022268,384,3,8,4,15,5,5
2022269,375,3,7,5,15,5,4
2022270,227,2,2,7,11,1,5
2022271,567,5,6,7,18,8,2
2022272,329,3,2,9,14,4,7
2022273,746,7,4,6,17,7,3
2022274,065,0,6,5,11,1,6
2022275,059,0,5,9,14,4,9
2022276,761,7,6,1,14,4,6
2022277,246,2,4,6,12,2,4
2022278,492,4,9,2,15,5,7
2022279,974,9,7,4,20,0,5
2022280,133,1,3,3,7,7,2
2022281,101,1,0,1,2,2,1
2022282,896,8,9,6,23,3,3
2022283,820,8,2,0,10,0,8
2022284,752,7,5,2,14,4,5
2022285,436,4,3,6,13,3,3
2022286,980,9,8,0,17,7,9
2022287,746,7,4,6,17,7,3
2022288,561,5,6,1,12,2,5
2022289,769,7,6,9,22,2,3
2022290,837,8,3,7,18,8,5
2022291,633,6,3,3,12,2,3
2022292,977,9,7,7,23,3,2
2022293,385,3,8,5,16,6,5
2022294,666,6,6,6,18,8,0
2022295,608,6,0,8,14,4,8
2022296,009,0,0,9,9,9,9
2022297,111,1,1,1,3,3,0
2022298,872,8,7,2,17,7,6
2022299,299,2,9,9,20,0,7
2022300,094,0,9,4,13,3,9
2022301,181,1,8,1,10,0,7
2022302,875,8,7,5,20,0,3
2022303,533,5,3,3,11,1,2
2022304,174,1,7,4,12,2,6
2022305,048,0,4,8,12,2,8
2022306,559,5,5,9,19,9,4
2022307,372,3,7,2,12,2,5
2022308,216,2,1,6,9,9,5
2022309,041,0,4,1,5,5,4
2022310,257,2,5,7,14,4,5
2022311,682,6,8,2,16,6,6
2022312,132,1,3,2,6,6,2
2022313,169,1,6,9,16,6,8
2022314,715,7,1,5,13,3,6
2022315,562,5,6,2,13,3,4
2022316,280,2,8,0,10,0,8
2022317,268,2,6,8,16,6,6
2022318,021,0,2,1,3,3,2
2022319,069,0,6,9,15,5,9
2022320,747,7,4,7,18,8,3
2022321,861,8,6,1,15,5,7
2022322,335,3,3,5,11,1,2
2022323,712,7,1,2,10,0,6
2022324,849,8,4,9,21,1,5
2022325,760,7,6,0,13,3,7
2022326,289,2,8,9,19,9,7
2022327,289,2,8,9,19,9,7
2022328,620,6,2,0,8,8,6
2022329,167,1,6,7,14,4,6
2022330,221,2,2,1,5,5,1
2022331,808,8,0,8,16,6,8
2022332,422,4,2,2,8,8,2
2022333,851,8,5,1,14,4,7
2022334,383,3,8,3,14,4,5
2022335,014,0,1,4,5,5,4
2022336,387,3,8,7,18,8,5
2022337,217,2,1,7,10,0,6
2022338,416,4,1,6,11,1,5
2022339,525,5,2,5,12,2,3
2022340,287,2,8,7,17,7,6
2022341,084,0,8,4,12,2,8
2022342,383,3,8,3,14,4,5
2022343,382,3,8,2,13,3,6
2022344,209,2,0,9,11,1,9
2022345,460,4,6,0,10,0,6
2022346,538,5,3,8,16,6,5
2022347,925,9,2,5,16,6,7
2022348,739,7,3,9,19,9,6
2022349,491,4,9,1,14,4,8
2022350,286,2,8,6,16,6,6
2022351,092,0,9,2,11,1,9
