issue,prize,hundred,ten,unit,sum,tail,gap
2012001,003,0,0,3,3,3,3
2012002,409,4,0,9,13,3,9
2012003,181,1,8,1,10,0,7
2012004,989,9,8,9,26,6,1
2012005,609,6,0,9,15,5,9
2012006,364,3,6,4,13,3,3
2012007,682,6,8,2,16,6,6
2012008,824,8,2,4,14,4,6
2012009,316,3,1,6,10,0,5
2012010,039,0,3,9,12,2,9
2012011,914,9,1,4,14,4,8
2012012,413,4,1,3,8,8,3
2012013,349,3,4,9,16,6,6
2012014,085,0,8,5,13,3,8
2012015,234,2,3,4,9,9,2
2012016,765,7,6,5,18,8,2
2012017,515,5,1,5,11,1,4
2012018,465,4,6,5,15,5,2
2012019,855,8,5,5,18,8,3
2012020,019,0,1,9,10,0,9
2012021,138,1,3,8,12,2,7
2012022,644,6,4,4,14,4,2
2012023,741,7,4,1,12,2,6
2012024,334,3,3,4,10,0,1
2012025,997,9,9,7,25,5,2
2012026,833,8,3,3,14,4,5
2012027,006,0,0,6,6,6,6
2012028,689,6,8,9,23,3,3
2012029,779,7,7,9,23,3,2
2012030,665,6,6,5,17,7,1
2012031,988,9,8,8,25,5,1
2012032,503,5,0,3,8,8,5
2012033,127,1,2,7,10,0,6
2012034,741,7,4,1,12,2,6
2012035,274,2,7,4,13,3,5
2012036,034,0,3,4,7,7,4
2012037,443,4,4,3,11,1,1
2012038,528,5,2,8,15,5,6
2012039,855,8,5,5,18,8,3
2012040,818,8,1,8,17,7,7
2012041,341,3,4,1,8,8,3
2012042,841,8,4,1,13,3,7
2012043,352,3,5,2,10,0,3
2012044,683,6,8,3,17,7,5
2012045,421,4,2,1,7,7,3
2012046,373,3,7,3,13,3,4
2012047,496,4,9,6,19,9,5
2012048,833,8,3,3,14,4,5
2012049,044,0,4,4,8,8,4
2012050,778,7,7,8,22,2,1
2012051,467,4,6,7,17,7,3
2012052,841,8,4,1,13,3,7
2012053,535,5,3,5,13,3,2
2012054,057,0,5,7,12,2,7
2012055,066,0,6,6,12,2,6
2012056,143,1,4,3,8,8,3
2012057,691,6,9,1,16,6,8
2012058,259,2,5,9,16,6,7
2012059,346,3,4,6,13,3,3
2012060,424,4,2,4,10,0,2
2012061,713,7,1,3,11,1,6
2012062,350,3,5,0,8,8,5
2012063,773,7,7,3,17,7,4
2012064,831,8,3,1,12,2,7
2012065,363,3,6,3,12,2,3
2012066,084,0,8,4,12,2,8
2012067,422,4,2,2,8,8,2
2012068,925,9,2,5,16,6,7
2012069,721,7,2,1,10,0,6
2012070,300,3,0,0,3,3,3
2012071,613,6,1,3,10,0,5
2012072,998,9,9,8,26,6,1
2012073,464,4,6,4,14,4,2
2012074,276,2,7,6,15,5,5
2012075,989,9,8,9,26,6,1
2012076,078,0,7,8,15,5,8
2012077,412,4,1,2,7,7,3
2012078,660,6,6,0,12,2,6
2012079,010,0,1,0,1,1,1
2012080,772,7,7,2,16,6,5
2012081,399,3,9,9,21,1,6
2012082,990,9,9,0,18,8,9
2012083,688,6,8,8,22,2,2
2012084,238,2,3,8,13,3,6
2012085,478,4,7,8,19,9,4
2012086,716,7,1,6,14,4,6
2012087,684,6,8,4,18,8,4
2012088,535,5,3,5,13,3,2
2012089,221,2,2,1,5,5,1
2012090,682,6,8,2,16,6,6
2012091,835,8,3,5,16,6,5
2012092,739,7,3,9,19,9,6
2012093,671,6,7,1,14,4,6
2012094,608,6,0,8,14,4,8
2012095,956,9,5,6,20,0,4
2012096,749,7,4,9,20,0,5
2012097,682,6,8,2,16,6,6
2012098,611,6,1,1,8,8,5
2012099,105,1,0,5,6,6,5
2012100,489,4,8,9,21,1,5
2012101,377,3,7,7,17,7,4
2012102,955,9,5,5,19,9,4
2012103,273,2,7,3,12,2,5
2012104,388,3,8,8,19,9,5
2012105,542,5,4,2,11,1,3
2012106,682,6,8,2,16,6,6
2012107,269,2,6,9,17,7,7
2012108,399,3,9,9,21,1,6
2012109,241,2,4,1,7,7,3
2012110,704,7,0,4,11,1,7
2012111,461,4,6,1,11,1,5
2012112,750,7,5,0,12,2,7
2012113,432,4,3,2,9,9,2
2012114,079,0,7,9,16,6,9
2012115,029,0,2,9,11,1,9
2012116,471,4,7,1,12,2,6
2012117,042,0,4,2,6,6,4
2012118,804,8,0,4,12,2,8
2012119,836,8,3,6,17,7,5
2012120,469,4,6,9,19,9,5
2012121,670,6,7,0,13,3,7
2012122,474,4,7,4,15,5,3
2012123,622,6,2,2,10,0,4
2012124,901,9,0,1,10,0,9
2012125,678,6,7,8,21,1,2
2012126,281,2,8,1,11,1,7
2012127,205,2,0,5,7,7,5
2012128,178,1,7,8,16,6,7
2012129,921,9,2,1,12,2,8
2012130,211,2,1,1,4,4,1
2012131,586,5,8,6,19,9,3
2012132,626,6,2,6,14,4,4
2012133,638,6,3,8,17,7,5
2012134,049,0,4,9,13,3,9
2012135,569,5,6,9,20,0,4
2012136,720,7,2,0,9,9,7
2012137,882,8,8,2,18,8,6
2012138,384,3,8,4,15,5,5
2012139,719,7,1,9,17,7,8
2012140,044,0,4,4,8,8,4
2012141,250,2,5,0,7,7,5
2012142,967,9,6,7,22,2,3
2012143,990,9,9,0,18,8,9
2012144,278,2,7,8,17,7,6
2012145,856,8,5,6,19,9,3
2012146,728,7,2,8,17,7,6
2012147,568,5,6,8,19,9,3
2012148,524,5,2,4,11,1,3
2012149,940,9,4,0,13,3,9
2012150,598,5,9,8,22,2,4
2012151,613,6,1,3,10,0,5
2012152,739,7,3,9,19,9,6
2012153,383,3,8,3,14,4,5
2012154,206,2,0,6,8,8,6
2012155,895,8,9,5,22,2,4
2012156,440,4,4,0,8,8,4
2012157,599,5,9,9,23,3,4
2012158,772,7,7,2,16,6,5
2012159,957,9,5,7,21,1,4
2012160,970,9,7,0,16,6,9
2012161,532,5,3,2,10,0,3
2012162,243,2,4,3,9,9,2
2012163,693,6,9,3,18,8,6
2012164,718,7,1,8,16,6,7
2012165,046,0,4,6,10,0,6
2012166,862,8,6,2,16,6,6
2012167,289,2,8,9,19,9,7
2012168,651,6,5,1,12,2,5
2012169,720,7,2,0,9,9,7
2012170,788,7,8,8,23,3,1
2012171,735,7,3,5,15,5,4
2012172,437,4,3,7,14,4,4
2012173,597,5,9,7,21,1,4
2012174,218,2,1,8,11,1,7
2012175,058,0,5,8,13,3,8
2012176,400,4,0,0,4,4,4
2012177,018,0,1,8,9,9,8
2012178,357,3,5,7,15,5,4
2012179,145,1,4,5,10,0,4
2012180,990,9,9,0,18,8,9
2012181,693,6,9,3,18,8,6
2012182,456,4,5,6,15,5,2
2012183,795,7,9,5,21,1,4
2012184,169,1,6,9,16,6,8
2012185,460,4,6,0,10,0,6
2012186,673,6,7,3,16,6,4
2012187,962,9,6,2,17,7,7
2012188,638,6,3,8,17,7,5
2012189,418,4,1,8,13,3,7
2012190,313,3,1,3,7,7,2
2012191,584,5,8,4,17,7,4
2012192,576,5,7,6,18,8,2
2012193,269,2,6,9,17,7,7
2012194,159,1,5,9,15,5,8
2012195,213,2,1,3,6,6,2
2012196,993,9,9,3,21,1,6
2012197,546,5,4,6,15,5,2
2012198,112,1,1,2,4,4,1
2012199,849,8,4,9,21,1,5
2012200,282,2,8,2,12,2,6
2012201,790,7,9,0,16,6,9
2012202,102,1,0,2,3,3,2
2012203,176,1,7,6,14,4,6
2012204,361,3,6,1,10,0,5
2012205,978,9,7,8,24,4,2
2012206,608,6,0,8,14,4,8
2012207,790,7,9,0,16,6,9
2012208,757,7,5,7,19,9,2
2012209,227,2,2,7,11,1,5
2012210,574,5,7,4,16,6,3
2012211,427,4,2,7,13,3,5
2012212,144,1,4,4,9,9,3
2012213,681,6,8,1,15,5,7
2012214,321,3,2,1,6,6,2
2012215,038,0,3,8,11,1,8
2012216,775,7,7,5,19,9,2
2012217,871,8,7,1,16,6,7
2012218,170,1,7,0,8,8,7
2012219,935,9,3,5,17,7,6
2012220,099,0,9,9,18,8,9
2012221,335,3,3,5,11,1,2
2012222,240,2,4,0,6,6,4
2012223,360,3,6,0,9,9,6
2012224,540,5,4,0,9,9,5
2012225,453,4,5,3,12,2,2
2012226,010,0,1,0,1,1,1
2012227,721,7,2,1,10,0,6
2012228,081,0,8,1,9,9,8
2012229,461,4,6,1,11,1,5
2012230,644,6,4,4,14,4,2
2012231,763,7,6,3,16,6,4
2012232,147,1,4,7,12,2,6
2012233,250,2,5,0,7,7,5
2012234,611,6,1,1,8,8,5
2012235,460,4,6,0,10,0,6
2012236,929,9,2,9,20,0,7
2012237,049,0,4,9,13,3,9
2012238,097,0,9,7,16,6,9
2012239,071,0,7,1,8,8,7
2012240,063,0,6,3,9,9,6
2012241,502,5,0,2,7,7,5
2012242,968,9,6,8,23,3,3
2012243,145,1,4,5,10,0,4
2012244,453,4,5,3,12,2,2
2012245,232,2,3,2,7,7,1
2012246,571,5,7,1,13,3,6
2012247,114,1,1,4,6,6,3
2012248,940,9,4,0,13,3,9
2012249,575,5,7,5,17,7,2
2012250,999,9,9,9,27,7,0
2012251,108,1,0,8,9,9,8
2012252,892,8,9,2,19,9,7
2012253,893,8,9,3,20,0,6
2012254,679,6,7,9,22,2,3
2012255,404,4,0,4,8,8,4
2012256,092,0,9,2,11,1,9
2012257,355,3,5,5,13,3,2
2012258,794,7,9,4,20,0,5
2012259,081,0,8,1,9,9,8
2012260,457,4,5,7,16,6,3
2012261,686,6,8,6,20,0,2
2012262,506,5,0,6,11,1,6
2012263,436,4,3,6,13,3,3
2012264,092,0,9,2,11,1,9
2012265,865,8,6,5,19,9,3
2012266,100,1,0,0,1,1,1
2012267,446,4,4,6,14,4,2
2012268,630,6,3,0,9,9,6
2012269,153,1,5,3,9,9,4
2012270,521,5,2,1,8,8,4
2012271,656,6,5,6,17,7,1
2012272,973,9,7,3,19,9,6
2012273,706,7,0,6,13,3,7
2012274,567,5,6,7,18,8,2
2012275,361,3,6,1,10,0,5
2012276,179,1,7,9,17,7,8
2012277,911,9,1,1,11,1,8
2012278,663,6,6,3,15,5,3
2012279,954,9,5,4,18,8,5
2012280,063,0,6,3,9,9,6
2012281,096,0,9,6,15,5,9
2012282,010,0,1,0,1,1,1
2012283,154,1,5,4,10,0,4
2012284,560,5,6,0,11,1,6
2012285,605,6,0,5,11,1,6
2012286,044,0,4,4,8,8,4
2012287,231,2,3,1,6,6,2
2012288,576,5,7,6,18,8,2
2012289,884,8,8,4,20,0,4
2012290,974,9,7,4,20,0,5
2012291,021,0,2,1,3,3,2
2012292,203,2,0,3,5,5,3
2012293,086,0,8,6,14,4,8
2012294,137,1,3,7,11,1,6
2012295,295,2,9,5,16,6,7
2012296,489,4,8,9,21,1,5
2012297,814,8,1,4,13,3,7
2012298,833,8,3,3,14,4,5
2012299,087,0,8,7,15,5,8
2012300,954,9,5,4,18,8,5
2012301,579,5,7,9,21,1,4
2012302,343,3,4,3,10,0,1
2012303,585,5,8,5,18,8,3
2012304,419,4,1,9,14,4,8
2012305,721,7,2,1,10,0,6
2012306,337,3,3,7,13,3,4
2012307,687,6,8,7,21,1,2
2012308,299,2,9,9,20,0,7
2012309,287,2,8,7,17,7,6
2012310,644,6,4,4,14,4,2
2012311,644,6,4,4,14,4,2
2012312,056,0,5,6,11,1,6
2012313,138,1,3,8,12,2,7
2012314,624,6,2,4,12,2,4
2012315,007,0,0,7,7,7,7
2012316,708,7,0,8,15,5,8
2012317,177,1,7,7,15,5,6
2012318,836,8,3,6,17,7,5
2012319,051,0,5,1,6,6,5
2012320,009,0,0,9,9,9,9
2012321,133,1,3,3,7,7,2
2012322,176,1,7,6,14,4,6
2012323,899,8,9,9,26,6,1
2012324,888,8,8,8,24,4,0
2012325,104,1,0,4,5,5,4
2012326,896,8,9,6,23,3,3
2012327,446,4,4,6,14,4,2
2012328,814,8,1,4,13,3,7
2012329,611,6,1,1,8,8,5
2012330,219,2,1,9,12,2,8
2012331,089,0,8,9,17,7,9
2012332,822,8,2,2,12,2,6
2012333,025,0,2,5,7,7,5
2012334,524,5,2,4,11,1,3
2012335,893,8,9,3,20,0,6
2012336,557,5,5,7,17,7,2
2012337,462,4,6,2,12,2,4
2012338,331,3,3,1,7,7,2
2012339,274,2,7,4,13,3,5
2012340,654,6,5,4,15,5,2
2012341,472,4,7,2,13,3,5
2012342,492,4,9,2,15,5,7
2012343,722,7,2,2,11,1,5
2012344,488,4,8,8,20,0,4
2012345,390,3,9,0,12,2,9
2012346,437,4,3,7,14,4,4
2012347,419,4,1,9,14,4,8
2012348,821,8,2,1,11,1,7
2012349,041,0,4,1,5,5,4
2012350,896,8,9,6,23,3,3
2012351,992,9,9,2,20,0,7
2012352,944,9,4,4,17,7,5
2012353,469,4,6,9,19,9,5
2012354,183,1,8,3,12,2,7
2012355,369,3,6,9,18,8,6
2012356,462,4,6,2,12,2,4
2012357,111,1,1,1,3,3,0
2012358,012,0,1,2,3,3,2
2012359,146,1,4,6,11,1,5
