issue,prize,hundred,ten,unit,sum,tail,gap
2005001,054,0,5,4,9,9,5
2005002,366,3,6,6,15,5,3
2005003,431,4,3,1,8,8,3
2005004,674,6,7,4,17,7,3
2005005,299,2,9,9,20,0,7
2005006,420,4,2,0,6,6,4
2005007,435,4,3,5,12,2,2
2005008,281,2,8,1,11,1,7
2005009,869,8,6,9,23,3,3
2005010,416,4,1,6,11,1,5
2005011,204,2,0,4,6,6,4
2005012,196,1,9,6,16,6,8
2005013,613,6,1,3,10,0,5
2005014,085,0,8,5,13,3,8
2005015,367,3,6,7,16,6,4
2005016,665,6,6,5,17,7,1
2005017,665,6,6,5,17,7,1
2005018,055,0,5,5,10,0,5
2005019,574,5,7,4,16,6,3
2005020,922,9,2,2,13,3,7
2005021,001,0,0,1,1,1,1
2005022,938,9,3,8,20,0,6
2005023,312,3,1,2,6,6,2
2005024,312,3,1,2,6,6,2
2005025,755,7,5,5,17,7,2
2005026,277,2,7,7,16,6,5
2005027,014,0,1,4,5,5,4
2005028,862,8,6,2,16,6,6
2005029,628,6,2,8,16,6,6
2005030,459,4,5,9,18,8,5
2005031,504,5,0,4,9,9,5
2005032,361,3,6,1,10,0,5
2005033,590,5,9,0,14,4,9
2005034,186,1,8,6,15,5,7
2005035,830,8,3,0,11,1,8
2005036,942,9,4,2,15,5,7
2005037,708,7,0,8,15,5,8
2005038,319,3,1,9,13,3,8
2005039,028,0,2,8,10,0,8
2005040,047,0,4,7,11,1,7
2005041,133,1,3,3,7,7,2
2005042,234,2,3,4,9,9,2
2005043,845,8,4,5,17,7,4
2005044,955,9,5,5,19,9,4
2005045,400,4,0,0,4,4,4
2005046,545,5,4,5,14,4,1
2005047,429,4,2,9,15,5,7
2005048,761,7,6,1,14,4,6
2005049,790,7,9,0,16,6,9
2005050,104,1,0,4,5,5,4
2005051,247,2,4,7,13,3,5
2005052,306,3,0,6,9,9,6
2005053,175,1,7,5,13,3,6
2005054,519,5,1,9,15,5,8
2005055,014,0,1,4,5,5,4
2005056,600,6,0,0,6,6,6
2005057,813,8,1,3,12,2,7
2005058,353,3,5,3,11,1,2
2005059,983,9,8,3,20,0,6
2005060,960,9,6,0,15,5,9
2005061,912,9,1,2,12,2,8
2005062,796,7,9,6,22,2,3
2005063,181,1,8,1,10,0,7
2005064,969,9,6,9,24,4,3
2005065,895,8,9,5,22,2,4
2005066,626,6,2,6,14,4,4
2005067,169,1,6,9,16,6,8
2005068,903,9,0,3,12,2,9
2005069,743,7,4,3,14,4,4
2005070,984,9,8,4,21,1,5
2005071,917,9,1,7,17,7,8
2005072,256,2,5,6,13,3,4
2005073,232,2,3,2,7,7,1
2005074,006,0,0,6,6,6,6
2005075,700,7,0,0,7,7,7
2005076,418,4,1,8,13,3,7
2005077,648,6,4,8,18,8,4
2005078,842,8,4,2,14,4,6
2005079,959,9,5,9,23,3,4
2005080,495,4,9,5,18,8,5
2005081,250,2,5,0,7,7,5
2005082,216,2,1,6,9,9,5
2005083,702,7,0,2,9,9,7
2005084,277,2,7,7,16,6,5
2005085,942,9,4,2,15,5,7
2005086,635,6,3,5,14,4,3
2005087,155,1,5,5,11,1,4
2005088,144,1,4,4,9,9,3
2005089,091,0,9,1,10,0,9
2005090,065,0,6,5,11,1,6
2005091,102,1,0,2,3,3,2
2005092,299,2,9,9,20,0,7
2005093,861,8,6,1,15,5,7
2005094,112,1,1,2,4,4,1
2005095,061,0,6,1,7,7,6
2005096,935,9,3,5,17,7,6
2005097,085,0,8,5,13,3,8
2005098,670,6,7,0,13,3,7
2005099,695,6,9,5,20,0,4
2005100,127,1,2,7,10,0,6
2005101,320,3,2,0,5,5,3
2005102,431,4,3,1,8,8,3
2005103,873,8,7,3,18,8,5
2005104,681,6,8,1,15,5,7
2005105,363,3,6,3,12,2,3
2005106,540,5,4,0,9,9,5
2005107,838,8,3,8,19,9,5
2005108,384,3,8,4,15,5,5
2005109,610,6,1,0,7,7,6
2005110,417,4,1,7,12,2,6
2005111,061,0,6,1,7,7,6
2005112,298,2,9,8,19,9,7
2005113,005,0,0,5,5,5,5
2005114,892,8,9,2,19,9,7
2005115,626,6,2,6,14,4,4
2005116,569,5,6,9,20,0,4
2005117,992,9,9,2,20,0,7
2005118,593,5,9,3,17,7,6
2005119,111,1,1,1,3,3,0
2005120,162,1,6,2,9,9,5
2005121,729,7,2,9,18,8,7
2005122,542,5,4,2,11,1,3
2005123,974,9,7,4,20,0,5
2005124,219,2,1,9,12,2,8
2005125,508,5,0,8,13,3,8
2005126,534,5,3,4,12,2,2
2005127,445,4,4,5,13,3,1
2005128,162,1,6,2,9,9,5
2005129,707,7,0,7,14,4,7
2005130,546,5,4,6,15,5,2
2005131,663,6,6,3,15,5,3
2005132,836,8,3,6,17,7,5
2005133,759,7,5,9,21,1,4
2005134,704,7,0,4,11,1,7
2005135,745,7,4,5,16,6,3
2005136,928,9,2,8,19,9,7
2005137,253,2,5,3,10,0,3
2005138,014,0,1,4,5,5,4
2005139,462,4,6,2,12,2,4
2005140,894,8,9,4,21,1,5
2005141,168,1,6,8,15,5,7
2005142,306,3,0,6,9,9,6
2005143,207,2,0,7,9,9,7
2005144,574,5,7,4,16,6,3
2005145,057,0,5,7,12,2,7
2005146,109,1,0,9,10,0,9
2005147,121,1,2,1,4,4,1
2005148,979,9,7,9,25,5,2
2005149,899,8,9,9,26,6,1
2005150,524,5,2,4,11,1,3
2005151,990,9,9,0,18,8,9
2005152,927,9,2,7,18,8,7
2005153,866,8,6,6,20,0,2
2005154,776,7,7,6,20,0,1
2005155,024,0,2,4,6,6,4
2005156,119,1,1,9,11,1,8
2005157,598,5,9,8,22,2,4
2005158,876,8,7,6,21,1,2
2005159,107,1,0,7,8,8,7
2005160,726,7,2,6,15,5,5
2005161,221,2,2,1,5,5,1
2005162,967,9,6,7,22,2,3
2005163,645,6,4,5,15,5,2
2005164,001,0,0,1,1,1,1
2005165,398,3,9,8,20,0,6
2005166,736,7,3,6,16,6,4
2005167,711,7,1,1,9,9,6
2005168,907,9,0,7,16,6,9
2005169,263,2,6,3,11,1,4
2005170,195,1,9,5,15,5,8
2005171,165,1,6,5,12,2,5
2005172,997,9,9,7,25,5,2
2005173,207,2,0,7,9,9,7
2005174,876,8,7,6,21,1,2
2005175,933,9,3,3,15,5,6
2005176,937,9,3,7,19,9,6
2005177,705,7,0,5,12,2,7
2005178,004,0,0,4,4,4,4
2005179,043,0,4,3,7,7,4
2005180,395,3,9,5,17,7,6
2005181,402,4,0,2,6,6,4
2005182,469,4,6,9,19,9,5
2005183,173,1,7,3,11,1,6
2005184,884,8,8,4,20,0,4
2005185,439,4,3,9,16,6,6
2005186,202,2,0,2,4,4,2
2005187,913,9,1,3,13,3,8
2005188,629,6,2,9,17,7,7
2005189,403,4,0,3,7,7,4
2005190,426,4,2,6,12,2,4
2005191,506,5,0,6,11,1,6
2005192,624,6,2,4,12,2,4
2005193,999,9,9,9,27,7,0
2005194,494,4,9,4,17,7,5
2005195,526,5,2,6,13,3,4
2005196,005,0,0,5,5,5,5
2005197,788,7,8,8,23,3,1
2005198,749,7,4,9,20,0,5
2005199,794,7,9,4,20,0,5
2005200,998,9,9,8,26,6,1
2005201,045,0,4,5,9,9,5
2005202,330,3,3,0,6,6,3
2005203,819,8,1,9,18,8,8
2005204,506,5,0,6,11,1,6
2005205,875,8,7,5,20,0,3
2005206,958,9,5,8,22,2,4
2005207,867,8,6,7,21,1,2
2005208,540,5,4,0,9,9,5
2005209,316,3,1,6,10,0,5
2005210,543,5,4,3,12,2,2
2005211,534,5,3,4,12,2,2
2005212,780,7,8,0,15,5,8
2005213,962,9,6,2,17,7,7
2005214,169,1,6,9,16,6,8
2005215,236,2,3,6,11,1,4
2005216,856,8,5,6,19,9,3
2005217,555,5,5,5,15,5,0
2005218,724,7,2,4,13,3,5
2005219,216,2,1,6,9,9,5
2005220,802,8,0,2,10,0,8
2005221,870,8,7,0,15,5,8
2005222,895,8,9,5,22,2,4
2005223,539,5,3,9,17,7,6
2005224,567,5,6,7,18,8,2
2005225,309,3,0,9,12,2,9
2005226,293,2,9,3,14,4,7
2005227,264,2,6,4,12,2,4
2005228,725,7,2,5,14,4,5
2005229,813,8,1,3,12,2,7
2005230,784,7,8,4,19,9,4
2005231,077,0,7,7,14,4,7
2005232,749,7,4,9,20,0,5
2005233,934,9,3,4,16,6,6
2005234,122,1,2,2,5,5,1
2005235,856,8,5,6,19,9,3
2005236,537,5,3,7,15,5,4
2005237,600,6,0,0,6,6,6
2005238,463,4,6,3,13,3,3
2005239,346,3,4,6,13,3,3
2005240,517,5,1,7,13,3,6
2005241,832,8,3,2,13,3,6
2005242,289,2,8,9,19,9,7
2005243,949,9,4,9,22,2,5
2005244,894,8,9,4,21,1,5
2005245,827,8,2,7,17,7,6
2005246,597,5,9,7,21,1,4
2005247,310,3,1,0,4,4,3
2005248,481,4,8,1,13,3,7
2005249,521,5,2,1,8,8,4
2005250,037,0,3,7,10,0,7
2005251,818,8,1,8,17,7,7
2005252,085,0,8,5,13,3,8
2005253,442,4,4,2,10,0,2
2005254,302,3,0,2,5,5,3
2005255,959,9,5,9,23,3,4
2005256,539,5,3,9,17,7,6
2005257,026,0,2,6,8,8,6
2005258,976,9,7,6,22,2,3
2005259,971,9,7,1,17,7,8
2005260,489,4,8,9,21,1,5
2005261,614,6,1,4,11,1,5
2005262,240,2,4,0,6,6,4
2005263,846,8,4,6,18,8,4
2005264,807,8,0,7,15,5,8
2005265,696,6,9,6,21,1,3
2005266,107,1,0,7,8,8,7
2005267,584,5,8,4,17,7,4
2005268,855,8,5,5,18,8,3
2005269,327,3,2,7,12,2,5
2005270,909,9,0,9,18,8,9
2005271,566,5,6,6,17,7,1
2005272,981,9,8,1,18,8,8
2005273,726,7,2,6,15,5,5
2005274,526,5,2,6,13,3,4
2005275,470,4,7,0,11,1,7
2005276,862,8,6,2,16,6,6
2005277,075,0,7,5,12,2,7
2005278,692,6,9,2,17,7,7
2005279,254,2,5,4,11,1,3
2005280,899,8,9,9,26,6,1
2005281,576,5,7,6,18,8,2
2005282,549,5,4,9,18,8,5
2005283,184,1,8,4,13,3,7
2005284,380,3,8,0,11,1,8
2005285,654,6,5,4,15,5,2
2005286,853,8,5,3,16,6,5
2005287,787,7,8,7,22,2,1
2005288,487,4,8,7,19,9,4
2005289,304,3,0,4,7,7,4
2005290,803,8,0,3,11,1,8
2005291,371,3,7,1,11,1,6
2005292,436,4,3,6,13,3,3
2005293,040,0,4,0,4,4,4
2005294,820,8,2,0,10,0,8
2005295,893,8,9,3,20,0,6
2005296,716,7,1,6,14,4,6
2005297,319,3,1,9,13,3,8
2005298,608,6,0,8,14,4,8
2005299,756,7,5,6,18,8,2
2005300,966,9,6,6,21,1,3
2005301,635,6,3,5,14,4,3
2005302,747,7,4,7,18,8,3
2005303,576,5,7,6,18,8,2
2005304,863,8,6,3,17,7,5
2005305,578,5,7,8,20,0,3
2005306,390,3,9,0,12,2,9
2005307,968,9,6,8,23,3,3
2005308,129,1,2,9,12,2,8
2005309,524,5,2,4,11,1,3
2005310,015,0,1,5,6,6,5
2005311,450,4,5,0,9,9,5
2005312,756,7,5,6,18,8,2
2005313,728,7,2,8,17,7,6
2005314,860,8,6,0,14,4,8
2005315,670,6,7,0,13,3,7
2005316,741,7,4,1,12,2,6
2005317,846,8,4,6,18,8,4
2005318,069,0,6,9,15,5,9
2005319,824,8,2,4,14,4,6
2005320,084,0,8,4,12,2,8
2005321,805,8,0,5,13,3,8
2005322,274,2,7,4,13,3,5
2005323,339,3,3,9,15,5,6
2005324,578,5,7,8,20,0,3
2005325,472,4,7,2,13,3,5
2005326,508,5,0,8,13,3,8
2005327,735,7,3,5,15,5,4
2005328,463,4,6,3,13,3,3
2005329,117,1,1,7,9,9,6
2005330,149,1,4,9,14,4,8
2005331,790,7,9,0,16,6,9
2005332,187,1,8,7,16,6,7
2005333,341,3,4,1,8,8,3
2005334,672,6,7,2,15,5,5
2005335,781,7,8,1,16,6,7
2005336,693,6,9,3,18,8,6
2005337,461,4,6,1,11,1,5
2005338,236,2,3,6,11,1,4
2005339,440,4,4,0,8,8,4
2005340,678,6,7,8,21,1,2
2005341,302,3,0,2,5,5,3
2005342,385,3,8,5,16,6,5
2005343,876,8,7,6,21,1,2
2005344,949,9,4,9,22,2,5
2005345,786,7,8,6,21,1,2
2005346,292,2,9,2,13,3,7
2005347,172,1,7,2,10,0,6
2005348,323,3,2,3,8,8,1
2005349,492,4,9,2,15,5,7
2005350,237,2,3,7,12,2,5
2005351,239,2,3,9,14,4,7
2005352,562,5,6,2,13,3,4
2005353,095,0,9,5,14,4,9
2005354,014,0,1,4,5,5,4
2005355,012,0,1,2,3,3,2
2005356,439,4,3,9,16,6,6
2005357,415,4,1,5,10,0,4
2005358,397,3,9,7,19,9,6
