issue,prize,hundred,ten,unit,sum,tail,gap
2018001,177,1,7,7,15,5,6
2018002,644,6,4,4,14,4,2
2018003,145,1,4,5,10,0,4
2018004,416,4,1,6,11,1,5
2018005,391,3,9,1,13,3,8
2018006,869,8,6,9,23,3,3
2018007,080,0,8,0,8,8,8
2018008,447,4,4,7,15,5,3
2018009,496,4,9,6,19,9,5
2018010,167,1,6,7,14,4,6
2018011,972,9,7,2,18,8,7
2018012,437,4,3,7,14,4,4
2018013,606,6,0,6,12,2,6
2018014,161,1,6,1,8,8,5
2018015,739,7,3,9,19,9,6
2018016,374,3,7,4,14,4,4
2018017,990,9,9,0,18,8,9
2018018,174,1,7,4,12,2,6
2018019,760,7,6,0,13,3,7
2018020,921,9,2,1,12,2,8
2018021,726,7,2,6,15,5,5
2018022,656,6,5,6,17,7,1
2018023,936,9,3,6,18,8,6
2018024,506,5,0,6,11,1,6
2018025,543,5,4,3,12,2,2
2018026,476,4,7,6,17,7,3
2018027,489,4,8,9,21,1,5
2018028,313,3,1,3,7,7,2
2018029,790,7,9,0,16,6,9
2018030,753,7,5,3,15,5,4
2018031,525,5,2,5,12,2,3
2018032,860,8,6,0,14,4,8
2018033,870,8,7,0,15,5,8
2018034,263,2,6,3,11,1,4
2018035,752,7,5,2,14,4,5
2018036,693,6,9,3,18,8,6
2018037,768,7,6,8,21,1,2
2018038,947,9,4,7,20,0,5
2018039,125,1,2,5,8,8,4
2018040,478,4,7,8,19,9,4
2018041,411,4,1,1,6,6,3
2018042,537,5,3,7,15,5,4
2018043,079,0,7,9,16,6,9
2018044,237,2,3,7,12,2,5
2018045,009,0,0,9,9,9,9
2018046,551,5,5,1,11,1,4
2018047,088,0,8,8,16,6,8
2018048,444,4,4,4,12,2,0
2018049,818,8,1,8,17,7,7
2018050,780,7,8,0,15,5,8
2018051,424,4,2,4,10,0,2
2018052,958,9,5,8,22,2,4
2018053,827,8,2,7,17,7,6
2018054,663,6,6,3,15,5,3
2018055,043,0,4,3,7,7,4
2018056,446,4,4,6,14,4,2
2018057,252,2,5,2,9,9,3
2018058,497,4,9,7,20,0,5
2018059,755,7,5,5,17,7,2
2018060,774,7,7,4,18,8,3
2018061,134,1,3,4,8,8,3
2018062,836,8,3,6,17,7,5
2018063,820,8,2,0,10,0,8
2018064,234,2,3,4,9,9,2
2018065,238,2,3,8,13,3,6
2018066,226,2,2,6,10,0,4
2018067,171,1,7,1,9,9,6
2018068,911,9,1,1,11,1,8
2018069,141,1,4,1,6,6,3
2018070,890,8,9,0,17,7,9
2018071,503,5,0,3,8,8,5
2018072,412,4,1,2,7,7,3
2018073,748,7,4,8,19,9,4
2018074,941,9,4,1,14,4,8
2018075,342,3,4,2,9,9,2
2018076,328,3,2,8,13,3,6
2018077,137,1,3,7,11,1,6
2018078,294,2,9,4,15,5,7
2018079,738,7,3,8,18,8,5
2018080,749,7,4,9,20,0,5
2018081,948,9,4,8,21,1,5
2018082,574,5,7,4,16,6,3
2018083,752,7,5,2,14,4,5
2018084,554,5,5,4,14,4,1
2018085,334,3,3,4,10,0,1
2018086,391,3,9,1,13,3,8
2018087,827,8,2,7,17,7,6
2018088,212,2,1,2,5,5,1
2018089,773,7,7,3,17,7,4
2018090,942,9,4,2,15,5,7
2018091,071,0,7,1,8,8,7
2018092,153,1,5,3,9,9,4
2018093,553,5,5,3,13,3,2
2018094,734,7,3,4,14,4,4
2018095,894,8,9,4,21,1,5
2018096,475,4,7,5,16,6,3
2018097,304,3,0,4,7,7,4
2018098,394,3,9,4,16,6,6
2018099,332,3,3,2,8,8,1
2018100,830,8,3,0,11,1,8
2018101,798,7,9,8,24,4,2
2018102,938,9,3,8,20,0,6
2018103,796,7,9,6,22,2,3
2018104,767,7,6,7,20,0,1
2018105,845,8,4,5,17,7,4
2018106,960,9,6,0,15,5,9
2018107,947,9,4,7,20,0,5
2018108,010,0,1,0,1,1,1
2018109,331,3,3,1,7,7,2
2018110,746,7,4,6,17,7,3
2018111,817,8,1,7,16,6,7
2018112,256,2,5,6,13,3,4
2018113,798,7,9,8,24,4,2
2018114,887,8,8,7,23,3,1
2018115,180,1,8,0,9,9,8
2018116,820,8,2,0,10,0,8
2018117,836,8,3,6,17,7,5
2018118,786,7,8,6,21,1,2
2018119,505,5,0,5,10,0,5
2018120,442,4,4,2,10,0,2
2018121,514,5,1,4,10,0,4
2018122,137,1,3,7,11,1,6
2018123,830,8,3,0,11,1,8
2018124,141,1,4,1,6,6,3
2018125,328,3,2,8,13,3,6
2018126,478,4,7,8,19,9,4
2018127,297,2,9,7,18,8,7
2018128,229,2,2,9,13,3,7
2018129,982,9,8,2,19,9,7
2018130,989,9,8,9,26,6,1
2018131,548,5,4,8,17,7,4
2018132,470,4,7,0,11,1,7
2018133,414,4,1,4,9,9,3
2018134,299,2,9,9,20,0,7
2018135,086,0,8,6,14,4,8
2018136,064,0,6,4,10,0,6
2018137,177,1,7,7,15,5,6
2018138,153,1,5,3,9,9,4
2018139,828,8,2,8,18,8,6
2018140,680,6,8,0,14,4,8
2018141,279,2,7,9,18,8,7
2018142,949,9,4,9,22,2,5
2018143,322,3,2,2,7,7,1
2018144,019,0,1,9,10,0,9
2018145,523,5,2,3,10,0,3
2018146,623,6,2,3,11,1,4
2018147,038,0,3,8,11,1,8
2018148,819,8,1,9,18,8,8
2018149,871,8,7,1,16,6,7
2018150,675,6,7,5,18,8,2
2018151,694,6,9,4,19,9,5
2018152,469,4,6,9,19,9,5
2018153,083,0,8,3,11,1,8
2018154,031,0,3,1,4,4,3
2018155,160,1,6,0,7,7,6
2018156,322,3,2,2,7,7,1
2018157,209,2,0,9,11,1,9
2018158,300,3,0,0,3,3,3
2018159,294,2,9,4,15,5,7
2018160,108,1,0,8,9,9,8
2018161,473,4,7,3,14,4,4
2018162,260,2,6,0,8,8,6
2018163,570,5,7,0,12,2,7
2018164,610,6,1,0,7,7,6
2018165,302,3,0,2,5,5,3
2018166,061,0,6,1,7,7,6
2018167,132,1,3,2,6,6,2
2018168,275,2,7,5,14,4,5
2018169,716,7,1,6,14,4,6
2018170,127,1,2,7,10,0,6
2018171,297,2,9,7,18,8,7
2018172,247,2,4,7,13,3,5
2018173,242,2,4,2,8,8,2
2018174,019,0,1,9,10,0,9
2018175,612,6,1,2,9,9,5
2018176,207,2,0,7,9,9,7
2018177,222,2,2,2,6,6,0
2018178,528,5,2,8,15,5,6
2018179,713,7,1,3,11,1,6
2018180,433,4,3,3,10,0,1
2018181,573,5,7,3,15,5,4
2018182,400,4,0,0,4,4,4
2018183,844,8,4,4,16,6,4
2018184,261,2,6,1,9,9,5
2018185,696,6,9,6,21,1,3
2018186,350,3,5,0,8,8,5
2018187,507,5,0,7,12,2,7
2018188,068,0,6,8,14,4,8
2018189,269,2,6,9,17,7,7
2018190,031,0,3,1,4,4,3
2018191,340,3,4,0,7,7,4
2018192,939,9,3,9,21,1,6
2018193,382,3,8,2,13,3,6
2018194,605,6,0,5,11,1,6
2018195,484,4,8,4,16,6,4
2018196,332,3,3,2,8,8,1
2018197,133,1,3,3,7,7,2
2018198,893,8,9,3,20,0,6
2018199,442,4,4,2,10,0,2
2018200,598,5,9,8,22,2,4
2018201,629,6,2,9,17,7,7
2018202,224,2,2,4,8,8,2
2018203,216,2,1,6,9,9,5
2018204,713,7,1,3,11,1,6
2018205,298,2,9,8,19,9,7
2018206,267,2,6,7,15,5,5
2018207,006,0,0,6,6,6,6
2018208,175,1,7,5,13,3,6
2018209,100,1,0,0,1,1,1
2018210,956,9,5,6,20,0,4
2018211,893,8,9,3,20,0,6
2018212,515,5,1,5,11,1,4
2018213,355,3,5,5,13,3,2
2018214,817,8,1,7,16,6,7
2018215,939,9,3,9,21,1,6
2018216,890,8,9,0,17,7,9
2018217,856,8,5,6,19,9,3
2018218,877,8,7,7,22,2,1
2018219,871,8,7,1,16,6,7
2018220,208,2,0,8,10,0,8
2018221,598,5,9,8,22,2,4
2018222,323,3,2,3,8,8,1
2018223,197,1,9,7,17,7,8
2018224,791,7,9,1,17,7,8
2018225,648,6,4,8,18,8,4
2018226,929,9,2,9,20,0,7
2018227,088,0,8,8,16,6,8
2018228,829,8,2,9,19,9,7
2018229,443,4,4,3,11,1,1
2018230,764,7,6,4,17,7,3
2018231,516,5,1,6,12,2,5
2018232,531,5,3,1,9,9,4
2018233,111,1,1,1,3,3,0
2018234,505,5,0,5,10,0,5
2018235,584,5,8,4,17,7,4
2018236,703,7,0,3,10,0,7
2018237,157,1,5,7,13,3,6
2018238,392,3,9,2,14,4,7
2018239,837,8,3,7,18,8,5
2018240,492,4,9,2,15,5,7
2018241,170,1,7,0,8,8,7
2018242,097,0,9,7,16,6,9
2018243,790,7,9,0,16,6,9
2018244,649,6,4,9,19,9,5
2018245,051,0,5,1,6,6,5
2018246,916,9,1,6,16,6,8
2018247,303,3,0,3,6,6,3
2018248,939,9,3,9,21,1,6
2018249,289,2,8,9,19,9,7
2018250,917,9,1,7,17,7,8
2018251,030,0,3,0,3,3,3
2018252,578,5,7,8,20,0,3
2018253,852,8,5,2,15,5,6
2018254,021,0,2,1,3,3,2
2018255,710,7,1,0,8,8,7
2018256,147,1,4,7,12,2,6
2018257,603,6,0,3,9,9,6
2018258,045,0,4,5,9,9,5
2018259,149,1,4,9,14,4,8
2018260,664,6,6,4,16,6,2
2018261,352,3,5,2,10,0,3
2018262,367,3,6,7,16,6,4
2018263,452,4,5,2,11,1,3
2018264,190,1,9,0,10,0,9
2018265,180,1,8,0,9,9,8
2018266,697,6,9,7,22,2,3
2018267,105,1,0,5,6,6,5
2018268,187,1,8,7,16,6,7
2018269,426,4,2,6,12,2,4
2018270,959,9,5,9,23,3,4
2018271,775,7,7,5,19,9,2
2018272,078,0,7,8,15,5,8
2018273,624,6,2,4,12,2,4
2018274,656,6,5,6,17,7,1
2018275,393,3,9,3,15,5,6
2018276,418,4,1,8,13,3,7
2018277,025,0,2,5,7,7,5
2018278,812,8,1,2,11,1,7
2018279,645,6,4,5,15,5,2
2018280,951,9,5,1,15,5,8
2018281,106,1,0,6,7,7,6
2018282,780,7,8,0,15,5,8
2018283,899,8,9,9,26,6,1
2018284,858,8,5,8,21,1,3
2018285,080,0,8,0,8,8,8
2018286,931,9,3,1,13,3,8
2018287,051,0,5,1,6,6,5
2018288,274,2,7,4,13,3,5
2018289,913,9,1,3,13,3,8
2018290,535,5,3,5,13,3,2
2018291,639,6,3,9,18,8,6
2018292,459,4,5,9,18,8,5
2018293,151,1,5,1,7,7,4
2018294,832,8,3,2,13,3,6
2018295,168,1,6,8,15,5,7
2018296,030,0,3,0,3,3,3
2018297,461,4,6,1,11,1,5
2018298,253,2,5,3,10,0,3
2018299,489,4,8,9,21,1,5
2018300,094,0,9,4,13,3,9
2018301,901,9,0,1,10,0,9
2018302,199,1,9,9,19,9,8
2018303,608,6,0,8,14,4,8
2018304,020,0,2,0,2,2,2
2018305,190,1,9,0,10,0,9
2018306,000,0,0,0,0,0,0
2018307,648,6,4,8,18,8,4
2018308,412,4,1,2,7,7,3
2018309,743,7,4,3,14,4,4
2018310,367,3,6,7,16,6,4
2018311,864,8,6,4,18,8,4
2018312,115,1,1,5,7,7,4
2018313,383,3,8,3,14,4,5
2018314,867,8,6,7,21,1,2
2018315,773,7,7,3,17,7,4
2018316,731,7,3,1,11,1,6
2018317,299,2,9,9,20,0,7
2018318,346,3,4,6,13,3,3
2018319,408,4,0,8,12,2,8
2018320,329,3,2,9,14,4,7
2018321,829,8,2,9,19,9,7
2018322,434,4,3,4,11,1,1
2018323,265,2,6,5,13,3,4
2018324,034,0,3,4,7,7,4
2018325,644,6,4,4,14,4,2
2018326,531,5,3,1,9,9,4
2018327,068,0,6,8,14,4,8
2018328,629,6,2,9,17,7,7
2018329,601,6,0,1,7,7,6
2018330,236,2,3,6,11,1,4
2018331,458,4,5,8,17,7,4
2018332,965,9,6,5,20,0,4
2018333,836,8,3,6,17,7,5
2018334,454,4,5,4,13,3,1
2018335,359,3,5,9,17,7,6
2018336,210,2,1,0,3,3,2
2018337,558,5,5,8,18,8,3
2018338,575,5,7,5,17,7,2
2018339,841,8,4,1,13,3,7
2018340,695,6,9,5,20,0,4
2018341,030,0,3,0,3,3,3
2018342,078,0,7,8,15,5,8
2018343,974,9,7,4,20,0,5
2018344,887,8,8,7,23,3,1
2018345,478,4,7,8,19,9,4
2018346,596,5,9,6,20,0,4
2018347,471,4,7,1,12,2,6
2018348,144,1,4,4,9,9,3
2018349,494,4,9,4,17,7,5
2018350,892,8,9,2,19,9,7
2018351,318,3,1,8,12,2,7
2018352,068,0,6,8,14,4,8
2018353,691,6,9,1,16,6,8
2018354,469,4,6,9,19,9,5
2018355,378,3,7,8,18,8,5
2018356,188,1,8,8,17,7,7
2018357,922,9,2,2,13,3,7
2018358,329,3,2,9,14,4,7
